11110000011111100111111000-
00110000011001100110011000-
00110000011001100110011000-
00110000011001100110011000-
00110000011001100110011000-
00110000011001100110011000-
00110000011001100110011000-
00111111111001111110011111-
00111111111001111110011111-
00000000000000000000000000-
00000000000000000000000000