11110000011111100111111000-
00110000011001100110011000-
00110000011001100110011000-
00110000011001100110011000-
00110000011001100110011000-
00110000011001100110011000-
00110000011001100110011000-
00111111111001111110011111-
00111111111001111110011111-
10000000000100000001000000